your name. (movie)	Makoto Shinkai
Fullmetal Alchemist: Brotherhood (TV)	Yasuhiro Irie
Steins;Gate (TV)	Hiroshi Hamasaki
Clannad After Story (TV)	Tatsuya Ishihara
Rurouni Kenshin: Trust & Betrayal (OAV)	Kazuhiro Furuhashi
Code Geass: Lelouch of the Rebellion R2 (TV)	Goro Taniguchi
Spirited Away (movie)	Hayao Miyazaki
A Silent Voice (movie)	Naoko Yamada
Cowboy Bebop (TV)	Melissa Williamson
Mushishi: The Next Chapter (TV)	Hiroshi Nagahama
Princess Mononoke (movie)	Hayao Miyazaki
(The) Disappearance of Haruhi Suzumiya (movie)	Yasuhiro Takemoto
(The) Legend of the Galactic Heroes (OAV)	Noboru Ishiguro
Mushi-Shi (TV)	Hiroshi Nagahama
Death Note (TV)	Tetsuro Araki
Maria Watches Over Us 3rd Season (OAV)	Yukihiro Matsushita
Made in Abyss (TV)	Masayuki Kojima
Maria Watches Over Us Season 2: Printemps (TV)	Yukihiro Matsushita
anohana: The Flower We Saw That Day (TV)	Tatsuyuki Nagai
Code Geass: Lelouch of the Rebellion (TV)	Goro Taniguchi
Gintama' (TV 2/2011)	Yoichi Fujita
Descending Stories: Showa Genroku Rakugo Shinju (TV)	Mamoru Hatakeyama
Maria Watches Over Us 4th Season (TV)	Toshiyuki Kato
Gintama' (TV 3/2012)	Yoichi Fujita
Gintama (TV 4/2015)	Chizuru Miyawaki
Bunny Drop (TV)	Kanta Kamei
Evangelion: 2.0 You Can (Not) Advance (movie)	Kazuya Tsurumaki
Monster (TV)	Masayuki Kojima
Grave of the Fireflies (movie)	Isao Takahata
Cross Game (TV)	Osamu Sekita
Ghost in the Shell: Stand Alone Complex 2nd GIG (TV)	Kenji Kamiyama
Summer Wars (movie)	Mamoru Hosoda
Fighting Spirit (TV)	Satoshi Nishimura
Hunter × Hunter (TV 2011)	Hiroshi Koujina
Fullmetal Alchemist (TV)	Seiji Mizushima
Nodame Cantabile (TV)	Kenichi Kasai
(The) Girl Who Leapt Through Time (movie)	Mamoru Hosoda
5 Centimeters Per Second (movie)	Makoto Shinkai
Nausicaä of the Valley of the Wind (movie)	Hayao Miyazaki
Gurren Lagann (TV)	Hiroyuki Imaishi
(The) Garden of Sinners (movie series)	Ei Aoki
Wolf Children (movie)	Mamoru Hosoda
My Neighbor Totoro (movie)	Hayao Miyazaki
Baccano! (TV)	Takahiro Ōmori
Gekijōban Gintama Kanketsu-hen: Yorozuya yo Eien Nare (movie)	Yoichi Fujita
Natsume's Book of Friends (TV 4)	Takahiro Ōmori
Honey and Clover II (TV)	Tatsuyuki Nagai
Star Blazers 2199 (TV)	unknown
Hajime no Ippo: New Challenger (TV)	Jun Shishido
Kanon (TV 2/2006)	Tatsuya Ishihara
GTO: Great Teacher Onizuka (TV)	Noriyuki Abe
Kino's Journey (TV)	Ryutaro Nakamura
Time of Eve (ONA)	Yasuhiro Yoshiura
Howl's Moving Castle (movie)	Hayao Miyazaki
Puella Magi Madoka Magica (TV)	Akiyuki Simbo
Mushishi Tokubetsu-hen: Hihamukage (special)	Hiroshi Nagahama
Time of Eve (movie)	Yasuhiro Yoshiura
Natsume's Book of Friends (TV 2)	Takahiro Ōmori
Monogatari Series Second Season (TV)	Eita Higashikubo
Millennium Actress (movie)	Satoshi Kon
Kaleido Star (TV)	Junichi Sato
Natsume's Book of Friends (TV 3)	Takahiro Ōmori
Kids on the Slope (TV)	Shinichiro Watanabe
Mononoke (TV)	Kenji Nakamura
(The) Melancholy of Haruhi Suzumiya (TV)	Tatsuya Ishihara
Gankutsuou: The Count of Monte Cristo (TV)	Mahiro Maeda
Clannad (TV)	Tatsuya Ishihara
Planetes (TV)	Goro Taniguchi
NANA (TV)	Morio Asaka
Looking Up At The Half-Moon (TV)	Yukihiro Matsushita
March comes in like a lion (TV 2)	Akiyuki Simbo
Castle in the Sky (movie)	Hayao Miyazaki
Whisper of the Heart (movie)	Yoshifumi Kondō
Your Lie in April (TV)	Kyōhei Ishiguro
Ouran High School Host Club (TV)	Takuya Igarashi
Samurai Champloo (TV)	Shinichiro Watanabe
Gurren Lagann the Movie – The Lights in the Sky Are Stars	Hiroyuki Imaishi
(The) Beast Player Erin (TV)	Takayuki Hamana
Ghost in the Shell: Stand Alone Complex (TV)	Kenji Kamiyama
Maria Watches Over Us (TV)	Yukihiro Matsushita
Aria the Origination (TV)	Junichi Sato
Angel Beats! (TV)	Seiji Kishi
Spice and Wolf II (TV)	Takeo Takahashi
A Place Further Than the Universe (TV)	Atsuko Ishizuka
Moribito - Guardian of the Spirit (TV)	Kenji Kamiyama
Haikyu!! Second Season (TV)	Susumu Mitsunaka
Re:ZERO -Starting Life in Another World- (TV)	Masaharu Watanabe
ef: a tale of melodies (TV)	Shin Oonuma
ef: a tale of memories (TV)	Shin Oonuma
Haikyu!! (TV 3)	Susumu Mitsunaka
Black Lagoon: The Second Barrage (TV)	Sunao Katabuchi
Welcome to the NHK (TV)	Yusuke Yamamoto
Legend of the Galactic Heroes: Overture to a New War (movie)	Keizō Shimizu
My Hero Academia (TV 2)	Kenji Nagasaki
Sword of the Stranger (movie)	Masahiro Ando
Honey and Clover (TV)	Kenichi Kasai
Haibane Renmei (TV)	Hiroshi Negishi
(The) Twelve Kingdoms (TV)	Tsuneo Kobayashi
(The) Tale of the Princess Kaguya (movie)	Isao Takahata
Hunter X Hunter (OAV)	Satoshi Saga
Cowboy Bebop: The Movie	Hiroyuki Okiura
Maquia - When the Promised Flower Blooms (movie)	Mari Okada
Toradora! (TV)	Tatsuyuki Nagai
Tokyo Godfathers (movie)	Satoshi Kon
Romeo × Juliet (TV)	Fumitoshi Oizaki
Shōwa Genroku Rakugo Shinjū (TV)	Mamoru Hatakeyama
Mushishi: Zoku-Shō: Suzu no Shizuku (movie)	Hiroshi Nagahama
Major (TV)	Kenichi Kasai
(The) Garden of Words (movie)	Makoto Shinkai
Evangelion: 1.0 You Are (Not) Alone (movie)	Kazuya Tsurumaki
Maison Ikkoku (TV)	Kazuo Yamazaki
Shirobako (TV)	Tsutomu Mizushima
Owarimonogatari (specials)	Tomoyuki Itamura
Hellsing Ultimate (OAV)	Hiroyuki Tanaka
Katanagatari (TV)	Keitaro Motonaga
Tsubasa Tokyo Revelations (OAV)	Shunsuke Tada
Chihayafuru (TV)	Morio Asaka
Full Metal Panic! The Second Raid (TV)	Yasuhiro Takemoto
Mobile Suit Gundam UC (OAV)	Kazuhiro Furuhashi
Hunter X Hunter (TV)	Miyadah Awda
Gintama. (TV 5/2017)	Chizuru Miyawaki
ERASED (TV)	Tomohiko Ito
My Hero Academia (TV 3)	Kenji Nagasaki
Fate/Zero (TV 2)	Ei Aoki
BECK: Mongolian Chop Squad (TV)	Osamu Kobayashi
Kimi ni Todoke - From Me to You (TV)	Hiro Kaburagi
(La) Maison en Petits Cubes (movie)	Kunio Katō
Den-noh Coil (TV)	Mitsuo Iso
Attack on Titan (TV 2/2017)	Masashi Koizuka
Bakuman. 2 (TV)	Kenichi Kasai
Natsume's Book of Friends (TV)	Takahiro Ōmori
Nodame Cantabile: Paris (TV)	Chiaki Kon
Berserk (TV)	Michael Sinterniklaas
Brave King GaoGaiGar Final (OAV)	Yoshitomo Kometani
JoJo's Bizarre Adventure: Diamond Is Unbreakable (TV)	Naokatsu Tsuda
Kaiba (TV)	Masaaki Yuasa
Ashita no Joe 2 (TV)	Osamu Dezaki
Ping Pong (TV)	Masaaki Yuasa
One Piece Episode of Nami: Kōkaishi no Namida to Nakama no Kizuna (special)	Katsumi Tokoro
Princess Tutu (TV)	Kiyoko Sayama
Conan, the Boy in Future (TV)	unknown
Natsume Yūjin-Chō Roku (TV 6)	Kotomi Deai
Hotarubi no Mori e (movie)	Takahiro Ōmori
Full Metal Panic? Fumoffu (TV)	Yasuhiro Takemoto
Azumanga Daioh (TV)	Hiroshi Nishikiori
Eden of the East (TV)	Kenji Kamiyama
Nodame Cantabile: Finale (TV)	Chiaki Kon
Haikyu!! (TV)	Susumu Mitsunaka
(The) Rose of Versailles (TV)	Osamu Dezaki
Hunter X Hunter: G I Final (OAV)	Makoto Satō
Yuri!!! on Ice (TV)	Sayo Yamamoto
Assassination Classroom (TV 2)	Seiji Kishi
Berserk: The Golden Age Arc III - The Advent (movie)	Toshiyuki Kubooka
Kimi ni Todoke 2nd Season (TV)	Hiro Kaburagi
Girls und Panzer der Film (movie)	Tsutomu Mizushima
Mushishi Zoku-Shō Tokubetsu-hen: Odoro no Michi (special)	Hiroshi Nagahama
Trigun (TV)	Satoshi Nishimura
Hanasaku Iroha - Blossoms for Tomorrow (TV)	Masahiro Ando
Ghost in the Shell: Stand Alone Complex: Solid State Society (movie)	Kenji Kamiyama
Mob Psycho 100 (TV)	Yuzuru Tachikawa
Paprika (movie)	Satoshi Kon
Spice and Wolf (TV)	Takeo Takahashi
Violet Evergarden (TV)	Taichi Ishidate
School Rumble: 2nd Semester (TV)	Takaomi Kanasaki
Magnetic Rose (movie)	Koji Morimoto
R.O.D -The TV-	Koji Masunari
Gungrave (TV)	Toshiyuki Tsuru
Sound! Euphonium 2 (TV)	Tatsuya Ishihara
Last Exile (TV)	Koichi Chigira
(The) Eccentric Family 2 (TV)	Masayuki Yoshihara
Land of the Lustrous (TV)	Takahiko Kyōgoku
When Marnie Was There (movie)	Hiromasa Yonebayashi
Rurouni Kenshin (TV)	Kazuhiro Furuhashi
Bakuman. 3 (TV)	Kenichi Kasai
Comedy (OAV)	Kazuto Nakazawa
Natsume Yūjin-Chō Go (TV 5)	Kotomi Deai
Legend of the Galactic Heroes: My Conquest is the Sea of Stars (movie)	Noboru Ishiguro
Skip Beat! (TV)	Kiyoko Sayama
xxxHOLiC: Kei (TV)	Tsutomu Mizushima
Bakemonogatari (TV)	Akiyuki Simbo
Neon Genesis Evangelion: The End of Evangelion (movie)	Hideaki Anno
Attack on Titan (TV)	Tetsuro Araki
(The) Super Dimension Fortress Macross: Do You Remember Love? (movie)	Noboru Ishiguro
In This Corner of the World (movie)	Sunao Katabuchi
Master Keaton (OAV)	unknown
Kiki's Delivery Service (movie)	Hayao Miyazaki
Hunter X Hunter: Greed Island (OAV)	Yukihiro Matsushita
Romeo and the Black Brothers (TV)	Kōzō Kusuba
Hajime no Ippo - Champion Road (special)	Satoshi Nishimura
No Game, No Life Zero (movie)	Atsuko Ishizuka
Gintama (TV)	Shinji Takamatsu
(The) Super Dimension Fortress Macross (TV)	unknown
Tiger & Bunny (TV)	Keiichi Satō
Black Lagoon (TV)	Sunao Katabuchi
Fate/stay night: Unlimited Blade Works (TV)	Takahiro Miura
Neon Genesis Evangelion (TV)	Hideaki Anno
One Outs (TV)	Yuzo Sato
Ghost in the Shell: Stand Alone Complex - Individual Eleven (OAV)	Kenji Kamiyama
(The) Anthem of the Heart (movie)	Tatsuyuki Nagai
(The) Boy and The Beast (movie)	Mamoru Hosoda
Food Wars! Shokugeki no Soma (TV)	Yoshitomo Yonetani
Darker than Black (TV)	Tensai Okamura
Macross Frontier (TV)	Yasuhito Kikuchi
Fate/Zero (TV)	Ei Aoki
Mobile Suit Gundam 00 Second Season (TV)	Seiji Mizushima
Space Brothers (TV)	Ayumu Watanabe
Hinamatsuri (TV)	Kei Oikawa
Monthly Girls' Nozaki-kun (TV)	Mitsue Yamazaki
Gosick (TV)	Hitoshi Nanba
Nichijou - My Ordinary Life (TV)	Tatsuya Ishihara
Welcome to THE SPACE SHOW (movie)	Koji Masunari
Denpa teki na Kanojo (OAV)	Mamoru Kanbe
Lupin III: The Castle of Cagliostro (movie)	Hayao Miyazaki
Aria the Avvenire (OAV)	Junichi Sato
Elfen Lied (TV)	Mamoru Kanbe
One Punch Man (TV)	Shingo Natsume
Emma: A Victorian Romance Second Act (TV)	Tsuneo Kobayashi
Nobody's Boy Remi (TV)	Osamu Dezaki
Wolf's Rain (OAV)	Tensai Okamura
Rainbow - Nisha Rokubō no Shichinin (TV)	Hiroshi Koujina
No Game, No Life (TV)	Atsuko Ishizuka
My Hero Academia (TV)	Kenji Nagasaki
Junjō Romantica 2 (TV)	Chiaki Kon
Ghost in the Shell: Stand Alone Complex - The Laughing Man (OAV)	Kenji Kamiyama
Magical Girl Lyrical Nanoha the Movie 2nd A's	Keizou Kusakawa
Eureka Seven (TV)	Kazuya Murata
Tokyo Magnitude 8.0 (TV)	Masaki Tachibana
Kill la Kill (TV)	Hiroyuki Imaishi
Kizumonogatari Part 1: Tekketsu (movie)	Tatsuya Oishi
School Rumble (TV)	Shinji Takamatsu
Parasyte -the maxim- (TV)	Kenichi Shimizu
Ghost in the Shell (movie)	Mamoru Oshii
Now and Then, Here and There (TV)	Akitarō Daichi
Wagnaria!!3 (TV)	Yumi Kamakura
Berserk: The Golden Age Arc II - The Battle for Doldrey (movie)	Toshiyuki Kubooka
Puella Magi Madoka Magica the Movie Part 2: Eternal	Yukihiro Miyamoto
planetarian: Hoshi no Hito (movie)	Naokatsu Tsuda
Puella Magi Madoka Magica the Movie Part 1: Beginnings	Yukihiro Miyamoto
Kizumonogatari Part 2: Nekketsu (movie)	Tatsuya Oishi
Kizumonogatari Part 3: Reiketsu (movie)	Tatsuya Oishi
Porco Rosso (movie)	Hayao Miyazaki
Kimagure Orange Road: The Movie	Tomomi Mochizuki
Lovely Complex (TV)	unknown
(The) Place Promised in Our Early Days (movie)	Makoto Shinkai
Hikaru No Go: New Year Special	Tetsuya Endo
Cardcaptor Sakura Movie 2: The Sealed Card	Morio Asaka
Hajime no Ippo - Mashiba vs. Kimura (OAV)	unknown
Legend of the Galactic Heroes: A Hundred Billion Stars, A Hundred Billion Lights (OAV)	Keizō Shimizu
Detroit Metal City (OAV)	Hiroshi Nagahama
Mobile Suit Gundam - The Movie Trilogy	Ryoji Fujiwara
(The) Wind Rises (movie)	Hayao Miyazaki
Puella Magi Madoka Magica The Movie Part 3: Rebellion	Yukihiro Miyamoto
Strawberry Panic! (TV)	Masayuki Sakoi
(The) Slayers Next (TV)	Heisaku Wada
One Piece Film Strong World (movie 10)	Munehisa Sakai
KenIchi the Mightiest Disciple (TV)	Hajime Kamegaki
Princess Jellyfish (TV)	Takahiro Ōmori
Bamboo Blade (TV)	Hisashi Saito
(The) Ancient Magus' Bride (TV)	Norihiro Naganuma
ReLIFE (OAV)	Tomochi Kosaka
Initial D: Fourth Stage (TV)	Shinji Kofukada
Mobile Suit Gundam 00 (TV)	Seiji Mizushima
Owarimonogatari (TV)	Tomoyuki Itamura
Silver Spoon (TV)	Tomohiko Ito
Hikaru no Go (TV)	Jun Kamiya
Hajime no Ippo Rising (TV)	Jun Shishido
Bakuman. (TV)	Kenichi Kasai
ReLIFE (TV)	Tomochi Kosaka
Banner of the Stars II (TV)	Yasuchika Nagaoka
Higurashi no Naku Koroni Kai (TV)	Chiaki Kon
Gunbuster (OAV)	Hideaki Anno
Case Closed: The Phantom of Baker Street (movie)	Kenji Kodama
Miss Kobayashi's Dragon Maid (TV)	Yasuhiro Takemoto
Voices of a Distant Star (OAV)	Makoto Shinkai
Samurai 7 (TV)	Toshifumi Takizawa
A Lull in the Sea (TV)	Toshiya Shinohara
Doraemon the Movie: Nobita and the Steel Troops: The New Age	Yukiyo Teramoto
Food Wars! The Second Plate (TV)	Yoshitomo Yonetani
Slam Dunk (TV)	unknown
Full Moon o Sagashite (TV)	Toshiyuki Kato
Mobile Suit Zeta Gundam (TV)	unknown
Case Closed: Captured in Her Eyes (movie)	Kenji Kodama
Sayonara, Zetsubou-Sensei (TV)	Akiyuki Simbo
Psycho-Pass (TV)	Naoyoshi Shiotani
Case Closed: The Last Magician of the Century (movie)	Kenji Kodama
(The) Secret World of Arrietty (movie)	Hiromasa Yonebayashi
(The) Story of Saiunkoku Second Series (TV 2)	Jun Shishido
FLCL (OAV)	Kazuya Tsurumaki
Treasure Island (TV)	Osamu Dezaki
Genshiken (TV)	Takashi Ikehata
Kyo kara Maoh! 3rd Series (TV)	Junji Nishimura
Black Lagoon: Roberta's Blood Trail (OAV)	Sunao Katabuchi
Touch (TV)	unknown
Case Closed: Countdown to Heaven (movie)	Kenji Kodama
Log Horizon (TV)	Shinji Ishihira
Genshiken 2 (TV)	Kinji Yoshimoto
Big Windup! Season 2 (TV)	Tsutomu Mizushima
(The) Garden of Sinners/recalled out summer (movie)	Tomonori Sudou
Kaleido Star: Legend of Phoenix - Layla Hamilton Story (OAV)	Junichi Sato
Aria - The Natural (TV)	Junichi Sato
Saint Seiya: The Hades Chapter - Sanctuary (OAV)	Javier Roldán
Junjō Romantica (TV)	Chiaki Kon
Claymore (TV)	Hiroyuki Tanaka
Zoku Sayonara Zetsubō Sensei (TV)	Akiyuki Simbo
Nisemonogatari (TV)	Akiyuki Simbo
Aggressive Retsuko (ONA)	Rarecho
Legend of the Galactic Heroes: Spiral Labyrinth (OAV)	Keizō Shimizu
Giant Robo (OAV)	Yasuhiro Imagawa
Non Non Biyori Repeat (TV)	Shinya Kawatsura
Fruits Basket (TV)	Akitarō Daichi
Black Butler: Book of Murder (OAV)	Noriyuki Abe
Perfect Blue (movie)	Satoshi Kon
When They Cry - Higurashi (TV)	Chiaki Kon
From Up On Poppy Hill (movie)	Goro Miyazaki
Birdy the Mighty Decode:02 (TV)	Kazuki Akane
Kimagure Orange Road (TV)	Osamu Kobayashi
Penguindrum (TV)	Kunihiko Ikuhara
Soul Eater (TV)	Takuya Igarashi
Hanada Shōnen-shi (TV)	Masayuki Kojima
Full Metal Panic! (TV)	Koichi Chigira
Haré+Guu Deluxe (OAV)	Tsutomu Mizushima
Mobile Suit Gundam: Iron-Blooded Orphans (TV 2)	Tatsuyuki Nagai
Baby Blue (movie)	Shinichiro Watanabe
Emma: A Victorian Romance (TV)	Tsuneo Kobayashi
xxxHOLiC: Rō (OAV)	Tsutomu Mizushima
Macross Zero (OAV)	Shoji Kawamori
Space Battleship Yamato 2199 (movie)	Yutaka Izubuchi
One Piece "3D2Y" Ace no Shi wo Koete! Luffy Nakama to no Chikai (special)	Naoyuki Itou
Chihayafuru 2 (TV)	Morio Asaka
Magical Girl Lyrical Nanoha A's (TV)	Keizou Kusakawa
Ace of Diamond: Second Season (TV)	Mitsuyuki Masuhara
Tamayura: Sotsugyō Shashin (movie series)	Junichi Sato
(The) Tatami Galaxy (TV)	Masaaki Yuasa
(The) Vision of Escaflowne (TV)	Kazuki Akane
Fairy Tail Zero (TV)	unknown
Read or Die (OAV)	Koji Masunari
(The) Eccentric Family (TV)	Masayuki Yoshihara
Durarara!! (TV)	Takahiro Ōmori
Broken Blade (movie series)	Nobuyoshi Habara
Ga-Rei-Zero (TV)	Ei Aoki
Yu Yu Hakusho: Ghost Files (TV)	Noriyuki Abe
Fate/stay night: Unlimited Blade Works (TV 2)	Takahiro Miura
Macross Plus Movie Edition	unknown
Kaiji (TV)	Yuzo Sato
(The) Story of Saiunkoku (TV)	Jun Shishido
Tsubasa: Spring Thunder (OAV)	Shunsuke Tada
Mobile Suit Gundam: The Origin (OAV)	Takashi Imanishi
Natsume Yūjin-Chō: Itsuka Yuki no Hi ni (OAV)	Takahiro Ōmori
KONOSUBA - God's blessing on this wonderful world! 2 (TV)	Takaomi Kanasaki
Crest of the Stars (TV)	Yasuchika Nagaoka
On Your Mark (movie)	Hayao Miyazaki
Gintama Season 4 (TV 6/2017)	Chizuru Miyawaki
Urusei Yatsura: Beautiful Dreamer (movie)	Mamoru Oshii
Gintama (OAV)	unknown
Toward the Terra (TV)	Osamu Yamasaki
Hanamonogatari (TV)	Tomoyuki Itamura
Genshiken (OAV)	Tsutomu Mizushima
Mind Game (movie)	Masaaki Yuasa
Mobile Suit Gundam Seed (TV)	Mitsuo Fukuda
Goku Sayonara Zetsubō Sensei (OAV)	Akiyuki Simbo
Fate/stay night: Heaven's Feel I. presage flower (movie)	Tomonori Sudou
One Piece Film Z (movie)	Tatsuya Nagamine
City Hunter 2 (TV)	Kenji Kodama
Redline (movie)	Takeshi Koike
Baby Steps (TV 2)	Masahiko Murata
Big Windup! (TV)	Tsutomu Mizushima
K-ON! (movie)	Naoko Yamada
Initial D: Second Stage (TV)	Shin'ichi Masaki
Daicon films (special)	Hiroyuki Yamaga
InuYasha: The Final Act (TV)	Yasunao Aoki
Gintama: The Movie	Shinji Takamatsu
Jormungand Perfect Order (TV)	Keitaro Motonaga
Mahō Sensei Negima!: Mō Hitotsu no Sekai (OAV)	Kobun Shizuno
(The) Disastrous Life of Saiki K. (TV 2)	Hiroaki Sakurai
Girls' Last Tour (TV)	Takaharu Ozaki
Doukyusei -Classmates- (movie)	Shouko Nakamura
Lunar Legend Tsukihime (TV)	Katsushi Sakurabi
Zan Sayonara Zetsubō Sensei (TV)	Akiyuki Simbo
Attack on Titan Part 2 – Jiyuu no Tsubasa (movie)	Tetsuro Araki
Saga of Tanya the Evil (TV)	Yutaka Uemura
Rurouni Kenshin: Reflection (OAV)	Kazuhiro Furuhashi
Hanasaku Iroha: Home Sweet Home (movie)	Masahiro Ando
Kurenai (TV)	Kou Matsuo
Patema Inverted (movie)	Yasuhiro Yoshiura
(The) Dog of Flanders (movie)	Yoshio Kuroda
(The) Irresponsible Captain Tylor (TV)	Kōichi Mashimo
Steins;Gate: The Movie - Load Region of Déjà Vu	Kanji Wakabayashi
Laid-Back Camp (TV)	Yoshiaki Kyougoku
Detective Conan: The Lost Ship in The Sky (movie 14)	Yasuichiro Yamamoto
Case Closed: The Fourteenth Target (movie)	Kenji Kodama
Banner of the Stars (TV)	Yasuchika Nagaoka
Barefoot Gen (movie)	Mori Masaki
Yona of the Dawn (TV)	Kazuhiro Yoneda
Revolutionary Girl Utena (TV)	Kunihiko Ikuhara
Kyousougiga (TV)	Rie Matsumoto
Barakamon (TV)	Masaki Tachibana
Wagnaria!!2 (TV)	Atsushi Ootsuki
Hidamari Sketch × Honeycomb (TV)	Akiyuki Simbo
Children Who Chase Lost Voices (movie)	Makoto Shinkai
Death Parade (TV)	Shinichiro Watanabe
Ghost in the Shell S.A.C. Solid State Society 3D (movie)	Kenji Kamiyama
My-HiME (TV)	Masakazu Obara
Tsukimonogatari (TV)	Tomoyuki Itamura
Shigofumi - Letters from the Departed (TV)	Tatsuo Sato
Trigun: Badlands Rumble (movie)	Satoshi Nishimura
One Piece (TV)	Hiroaki Miyamoto
(The) Ancient Magus' Bride: Those Awaiting a Star (OAV)	Norihiro Naganuma
Silver Spoon (TV 2)	Kotomi Deai
INTERSTELLA 5555: The 5tory of the 5ecret 5tar 5ystem (movie)	Kazuhisa Takenouchi
Sound! Euphonium (TV)	Tatsuya Ishihara
Hidamari Sketch × Hoshimittsu (TV)	Akiyuki Simbo
Lucky Star (TV)	Yasuhiro Takemoto
RahXephon (TV)	unknown
My Teen Romantic Comedy SNAFU TOO! (TV)	Kei Oikawa
Tsukigakirei (TV)	Seiji Kishi
Gurren Lagann the Movie –Childhood's End-	Hiroyuki Imaishi
His and Her Circumstances (TV)	Hideaki Anno
Berserk: The Golden Age Arc I - The Egg of the King (movie)	Koichi Hatsumi
Kobato. (TV)	Mitsuyuki Masuhara
Vampire Hunter D: Bloodlust (movie)	Yoshiaki Kawajiri
School Rumble: Extra Class (OAV)	Shinji Takamatsu
Nekomonogatari (Black) (TV)	Tomoyuki Itamura
House of Five Leaves (TV)	Tomomi Mochizuki
Attack on Titan: No Regrets (OAV)	Tetsuro Araki
Glass Mask (TV 2/2005)	Mamoru Hamatsu
My Love Story!! (TV)	Morio Asaka
Daily Lives of High School Boys (TV)	Shinji Takamatsu
Hozuki's Coolheadedness (TV 2)	Kazuhiro Yoneda
Love, Chunibyo & Other Delusions! (TV)	Tatsuya Ishihara
Full Metal Panic! Invisible Victory (TV)	Katsuichi Nakayama
Food Wars! The Third Plate (TV 2)	Yoshitomo Yonetani
Ergo Proxy (TV)	Shukou Murase
Tenchi Muyo! Ryo-Ohki (OAV 2/1994)	Kenichi Yatagai
Master Keaton (TV)	unknown
Initial D: Third Stage (movie)	Fumitsugu Yamaguchi
Strawberry Marshmallow (OAV)	Takuya Satō
Inuyashiki Last Hero (TV)	Shuhei Yabuta
Final Fantasy VII: Advent Children (movie)	Isao Nakajima
Banner of the Stars III (OAV)	Yasuchika Nagaoka
Fullmetal Alchemist: The Movie - Conqueror of Shamballa	Seiji Mizushima
Macross Plus (OAV)	Shinichiro Watanabe
Hayate the Combat Butler!! (TV)	Yoshiaki Iwasaki
JoJo's Bizarre Adventure: Stardust Crusaders Egypt Arc (TV)	Naokatsu Tsuda
Hyōka (TV)	Yasuhiro Takemoto
Ghost in the Shell: Arise (OAV)	Atsushi Takeuchi
Initial D: Final Stage (TV)	Mitsuo Hashimoto
Tekkonkinkreet (movie)	Michael Arias
Tiger & Bunny The Movie -The Rising-	Yoshitomo Yonetani
Tari Tari (TV)	Masakazu Hashimoto
Detective Conan: The Private Eyes' Requiem (movie 10)	Shouji Takizawa
Hidamari Sketch: Sae/Hiro Sotsugyō-hen (OAV)	Akiyuki Simbo
(The) Seven Deadly Sins: Revival of The Commandments (TV)	Takeshi Furuta
Moshidora (TV)	Takayuki Hamana
Shakugan no Shana (TV)	Takashi Watanabe
Hidamari Sketch × Hoshimittsu (special)	Akiyuki Simbo
Little Witch Academia (movie)	Yoh Yoshinari
Rage of Bahamut: Genesis (TV)	Keiichi Satō
(The) Cat Returns (movie)	Hiroyuki Morita
White Album 2 (TV)	Masaomi Andō
Kino's Travels: Life Goes On (movie)	Takashi Watanabe
xxxHOLiC: Shunmuki (OAV)	Tsutomu Mizushima
xxxHOLiC: Rō Adayume (OAV)	Tsutomu Mizushima
Heartcatch Precure! Hana no Miyako de Fashion Show…Desu ka!? (movie)	Rie Matsumoto
Mobile Suit Gundam: The 08th MS Team (OAV)	Takeyuki Kanda
Ushio & Tora (TV 2)	Satoshi Nishimura
Kamichu! (TV)	Hiroyuki Hata
Scrapped Princess (TV)	Sōichi Masui
Noein - to your other self (TV)	Kazuki Akane
Sword Art Online the Movie: Ordinal Scale	Tomohiko Ito
A Letter to Momo (movie)	Hiroyuki Okiura
Seto no Hanayome (OAV)	Seiji Kishi
GATE (TV 2)	Takahiko Kyōgoku
Little Witch Academia (TV)	Yoh Yoshinari
Shonen Onmyouji (TV)	Kunihiro Mori
Hidamari Sketch × 365 (TV)	Akiyuki Simbo
Full Metal Panic! The Second Raid (OAV)	Yasuhiro Takemoto
Tenchi Muyo! War on Geminar (OAV)	Koji Yoshikawa
Food Wars! The Third Plate (TV)	Yoshitomo Yonetani
planetarian (ONA)	Naokatsu Tsuda
Zan Sayonara Zetsubō Sensei Bangai-chi (OAV)	Akiyuki Simbo
Queen Millennia (TV)	Nobutaka Nishizawa
Gunslinger Girl (TV)	Morio Asaka
Megalobox (TV)	You Moriyama
Another (TV)	Tsutomu Mizushima
Detective Conan: The Raven Chaser (movie 13)	Shouji Takizawa
Colorful (movie)	Keiichi Hara
From the New World (TV)	Masashi Ishihama
Aura: Koga Maryuin's Last War (movie)	Seiji Kishi
Waiting in the Summer (TV)	Tatsuyuki Nagai
Giovanni's Island (movie)	Mizuho Nishikubo
Akira (movie)	Katsuhiro Otomo
Blood+ (TV)	Jun Matsumoto
Case Closed The Movie: The Time Bombed Skyscraper	Kenji Kodama
Macross Frontier: Sayonara no Tsubasa (movie)	Shoji Kawamori
Macross Frontier: Itsuwari no Utahime (movie)	Shoji Kawamori
Aria the Animation (TV)	Junichi Sato
Strawberry Marshmallow (TV)	Takuya Satō
(The) Disastrous Life of Saiki K. (TV)	Hiroaki Sakurai
Hidamari Sketch × 365 (special)	Akiyuki Simbo
Initial D: Fifth Stage (TV)	Mitsuo Hashimoto
