your name. (movie)	Amuse
Fullmetal Alchemist: Brotherhood (TV)	Aniplex
Steins;Gate (TV)	Katsuharu Nagata
Clannad After Story (TV)	Tokyo Broadcasting System
Rurouni Kenshin: Trust & Betrayal (OAV)	Aniplex
Code Geass: Lelouch of the Rebellion R2 (TV)	Bandai Co., Ltd.
Spirited Away (movie)	Studio Ghibli
A Silent Voice (movie)	ABC Animation
Cowboy Bebop (TV)	Bandai Visual
Mushishi: The Next Chapter (TV)	Atsushi Suzuki
Princess Mononoke (movie)	Dentsu Inc.
(The) Disappearance of Haruhi Suzumiya (movie)	Kadokawa Pictures
(The) Legend of the Galactic Heroes (OAV)	K Factory
Mushi-Shi (TV)	avex entertainment
Death Note (TV)	D.N. Dream Partners
Made in Abyss (TV)	Crystal Ruiz
Maria Watches Over Us 3rd Season (OAV)	d-rights
Maria Watches Over Us Season 2: Printemps (TV)	d-rights
Gintama' (TV 2/2011)	Dentsu Inc.
Code Geass: Lelouch of the Rebellion (TV)	Bandai Co., Ltd.
Descending Stories: Showa Genroku Rakugo Shinju (TV)	unknown
anohana: The Flower We Saw That Day (TV)	Atsushi Terada
Maria Watches Over Us 4th Season (TV)	d-rights
Gintama' (TV 3/2012)	unknown
Gintama (TV 4/2015)	unknown
Bunny Drop (TV)	Dentsu Inc.
Evangelion: 2.0 You Can (Not) Advance (movie)	Khara
Monster (TV)	Madhouse
Grave of the Fireflies (movie)	Seraphim Digital
Ghost in the Shell: Stand Alone Complex 2nd GIG (TV)	Bandai Entertainment
Cross Game (TV)	Shogakukan-Shueisha Productions
Summer Wars (movie)	Fumihiro Hirai
Fighting Spirit (TV)	VAP
Fullmetal Alchemist (TV)	Aniplex
Hunter × Hunter (TV 2011)	Madhouse
Nodame Cantabile (TV)	Kouichi Uchida
(The) Girl Who Leapt Through Time (movie)	Haruo Kawashima
Nausicaä of the Valley of the Wind (movie)	Toru Hara
5 Centimeters Per Second (movie)	CoMix Wave Films
Gurren Lagann (TV)	Aniplex
(The) Garden of Sinners (movie series)	Aniplex
Wolf Children (movie)	Fumihiro Hirai
My Neighbor Totoro (movie)	Studio Ghibli
Baccano! (TV)	Aniplex
Natsume's Book of Friends (TV 4)	NAS
Honey and Clover II (TV)	Kouichi Uchida
Gintama: The Final Movie	Aniplex
Hajime no Ippo: New Challenger (TV)	D.N. Dream Partners
Kanon (TV 2/2006)	Hyakkaya
GTO: Great Teacher Onizuka (TV)	Aniplex
Kino's Journey (TV)	A.C.G.T
Star Blazers 2199 (TV)	Bandai Co., Ltd.
Howl's Moving Castle (movie)	Howl's Moving Castle Production Committee
Time of Eve (ONA)	Directions, Inc.
Puella Magi Madoka Magica (TV)	Aniplex
Mushishi Tokubetsu-hen: Hihamukage (special)	Aniplex
Natsume's Book of Friends (TV 2)	unknown
Millennium Actress (movie)	Bandai Visual
Time of Eve (movie)	Directions, Inc.
Monogatari Series Second Season (TV)	Aniplex
Kaleido Star (TV)	HoriPro
Mononoke (TV)	Asmik Ace Entertainment, Inc.
Kids on the Slope (TV)	Dentsu Inc.
Natsume's Book of Friends (TV 3)	Aniplex
(The) Melancholy of Haruhi Suzumiya (TV)	Kadokawa Pictures
Gankutsuou: The Count of Monte Cristo (TV)	GONZO
Clannad (TV)	Tokyo Broadcasting System
Planetes (TV)	Bandai Visual
NANA (TV)	Madhouse
Looking Up At The Half-Moon (TV)	Pony Canyon
Castle in the Sky (movie)	Toru Hara
Whisper of the Heart (movie)	Shueisha
Your Lie in April (TV)	Aniplex
Samurai Champloo (TV)	Barnum Studio
Ouran High School Host Club (TV)	BONES
A Place Further Than the Universe (TV)	AT-X
(The) Beast Player Erin (TV)	NHK Enterprises
Gurren Lagann the Movie – The Lights in the Sky Are Stars	Aniplex
March comes in like a lion (TV 2)	Aniplex
Haikyu!! Second Season (TV)	Crystal Ruiz
Ghost in the Shell: Stand Alone Complex (TV)	Animax
Maria Watches Over Us (TV)	d-rights
Aria the Origination (TV)	ARIA Company
Spice and Wolf II (TV)	Kadokawa Pictures
Moribito - Guardian of the Spirit (TV)	Dentsu Inc.
Haikyu!! (TV 3)	Keiji Ota
Angel Beats! (TV)	Aniplex
ef: a tale of melodies (TV)	ef Production Committe
Mushishi: Zoku-Shō: Suzu no Shizuku (movie)	unknown
ef: a tale of memories (TV)	ef Production Committe
Black Lagoon: The Second Barrage (TV)	Black Lagoon Production Team
Welcome to the NHK (TV)	NHK ni Youkoso! Production Team
Re:ZERO -Starting Life in Another World- (TV)	Media Factory
Honey and Clover (TV)	Kouichi Uchida
(The) Tale of the Princess Kaguya (movie)	Koji Hoshino
Sword of the Stranger (movie)	unknown
Legend of the Galactic Heroes: Overture to a New War (movie)	SUNTORY
Haibane Renmei (TV)	Akihiro Yuasa
My Hero Academia (TV 2)	Toho Animation
Hunter X Hunter (OAV)	Hunter x Hunter OVA Production Committee
(The) Twelve Kingdoms (TV)	Nep 21
Cowboy Bebop: The Movie	Bandai Visual
Tokyo Godfathers (movie)	Dentsu Inc.
Toradora! (TV)	GENCO
Romeo × Juliet (TV)	Chubu-Nippon Broadcasting Co., Ltd.
Maison Ikkoku (TV)	Fuji Television Network
Major (TV)	NHK
Shōwa Genroku Rakugo Shinjū (TV)	unknown
Evangelion: 1.0 You Are (Not) Alone (movie)	Khara
Hellsing Ultimate (OAV)	G.D.H.
Shirobako (TV)	Docomo Anime Store
Chihayafuru (TV)	Nippon Television Network
Tsubasa Tokyo Revelations (OAV)	Kodansha
Katanagatari (TV)	Aniplex
Mobile Suit Gundam UC (OAV)	Bandai Visual
(The) Garden of Words (movie)	CoMix Wave Films
Gintama. (TV 5/2017)	unknown
Full Metal Panic! The Second Raid (TV)	Full Metal Panic! Film Partners
My Hero Academia (TV 3)	Toho Animation
Lupin the Third: Part 5 (TV)	Nippon Animation
Hunter X Hunter (TV)	Nippon Animation
Fate/Zero (TV 2)	Aniplex
Kimi ni Todoke - From Me to You (TV)	D.N. Dream Partners
BECK: Mongolian Chop Squad (TV)	Asatsu
ERASED (TV)	Aniplex
Den-noh Coil (TV)	Bandai Visual
(La) Maison en Petits Cubes (movie)	Robot
Bakuman. 2 (TV)	NHK
One Piece Episode of Nami: Kōkaishi no Namida to Nakama no Kizuna (special)	unknown
Attack on Titan (TV 2/2017)	Dentsu Inc.
Natsume's Book of Friends (TV)	NAS
Nodame Cantabile: Paris (TV)	Asmik Ace Entertainment, Inc.
JoJo's Bizarre Adventure: Diamond Is Unbreakable (TV)	JoJo's Bizarre Adventure DU Production Committee
Berserk (TV)	Hakusensha
Brave King GaoGaiGar Final (OAV)	Sunrise
Owarimonogatari (specials)	Aniplex
Kaiba (TV)	Madhouse
Ping Pong (TV)	Aniplex
Princess Tutu (TV)	Dentsu Inc.
Conan, the Boy in Future (TV)	NHK
Hotarubi no Mori e (movie)	Aniplex
Azumanga Daioh (TV)	Azumanga Daioh Production Committee
Full Metal Panic? Fumoffu (TV)	Ani Village
Mushishi Zoku-Shō Tokubetsu-hen: Odoro no Michi (special)	Aniplex
(The) Rose of Versailles (TV)	Tokyo Movie Shinsha
Nodame Cantabile: Finale (TV)	Asmik Ace Entertainment, Inc.
Eden of the East (TV)	Hiroko Yamada
Hunter X Hunter: G I Final (OAV)	Hunter x Hunter OVA Production Committee
Haikyu!! (TV)	Mainichi Broadcasting System
Maquia - When the Promised Flower Blooms (movie)	unknown
Natsume Yūjin-Chō Roku (TV 6)	NAS
Yuri!!! on Ice (TV)	unknown
Girls und Panzer der Film (movie)	Bandai Visual
Kimi ni Todoke 2nd Season (TV)	D.N. Dream Partners
Assassination Classroom (TV 2)	BS Fuji
Trigun (TV)	Victor Entertainment
Mob Psycho 100 (TV)	BONES
Hanasaku Iroha - Blossoms for Tomorrow (TV)	Bandai Visual
Ghost in the Shell: Stand Alone Complex: Solid State Society (movie)	Production I.G
Violet Evergarden (TV)	ABC Animation
Spice and Wolf (TV)	Spice & Wolf Production Committee
Paprika (movie)	Sony Pictures
Magnetic Rose (movie)	Studio 4°C
School Rumble: 2nd Semester (TV)	Marvelous Entertainment
R.O.D -The TV-	Aniplex
Berserk: The Golden Age Arc III - The Advent (movie)	BERSERK FILM PARTNERS
Ashita no Joe 2 (TV)	Tokyo Movie Shinsha
Sound! Euphonium 2 (TV)	Kyoto Animation
(The) Eccentric Family 2 (TV)	unknown
Gungrave (TV)	Flying Dog
Last Exile (TV)	MC Entertainment
Bakuman. 3 (TV)	NHK
Legend of the Galactic Heroes: My Conquest is the Sea of Stars (movie)	Kitty Films
Rurouni Kenshin (TV)	Aniplex
Comedy (OAV)	Studio 4°C
When Marnie Was There (movie)	Koji Hoshino
Skip Beat! (TV)	Hakusensha
Land of the Lustrous (TV)	Crystal Ruiz
Natsume Yūjin-Chō Go (TV 5)	NAS
xxxHOLiC: Kei (TV)	BMG Japan
Attack on Titan (TV)	Dentsu Inc.
Neon Genesis Evangelion: The End of Evangelion (movie)	Hiroyuki Yamaga
Bakemonogatari (TV)	Aniplex
In This Corner of the World (movie)	AT-X
Master Keaton (OAV)	Shogakukan-Shueisha Productions
(The) Super Dimension Fortress Macross: Do You Remember Love? (movie)	Artland
Kiki's Delivery Service (movie)	Studio Ghibli
Hunter X Hunter: Greed Island (OAV)	Nippon Animation
Romeo and the Black Brothers (TV)	Fuji Television Network
(The) Super Dimension Fortress Macross (TV)	Anime Friend
Hajime no Ippo - Champion Road (special)	unknown
Gintama (TV)	Dentsu Inc.
(The) Boy and The Beast (movie)	Chukyo TV
One Outs (TV)	D.N. Dream Partners
Black Lagoon (TV)	Black Lagoon Production Team
Neon Genesis Evangelion (TV)	GAINAX
Tiger & Bunny (TV)	Bandai Visual
Ghost in the Shell: Stand Alone Complex - Individual Eleven (OAV)	Bandai Entertainment
No Game, No Life Zero (movie)	unknown
Fate/stay night: Unlimited Blade Works (TV)	Aniplex
Food Wars! Shokugeki no Soma (TV)	Hiroo Maruyama
(The) Anthem of the Heart (movie)	A-1 Pictures
Fate/Zero (TV)	Aniplex
Macross Frontier (TV)	Bandai Visual
Mobile Suit Gundam 00 Second Season (TV)	Mainichi Broadcasting System
Darker than Black (TV)	Aniplex
Nichijou - My Ordinary Life (TV)	Kadokawa Pictures
Space Brothers (TV)	A-1 Pictures
Gosick (TV)	BONES
One Punch Man (TV)	Asatsu
Lupin III: The Castle of Cagliostro (movie)	Kazuhiko Yagiuchi
Aria the Avvenire (OAV)	Shochiku
Denpa teki na Kanojo (OAV)	unknown
Welcome to THE SPACE SHOW (movie)	Atsuhiro Iwakami
My Hero Academia (TV)	Toho Animation
Nobody's Boy Remi (TV)	TMS Entertainment
Emma: A Victorian Romance Second Act (TV)	Ajiado
Monthly Girls' Nozaki-kun (TV)	AT-X
Kizumonogatari Part 3: Reiketsu (movie)	Aniplex
Elfen Lied (TV)	GENCO
Wolf's Rain (OAV)	Asatsu-DK
No Game, No Life (TV)	Kadokawa
Rainbow - Nisha Rokubō no Shichinin (TV)	VAP
Junjō Romantica 2 (TV)	Frontier Works
Ghost in the Shell: Stand Alone Complex - The Laughing Man (OAV)	Animax
Magical Girl Lyrical Nanoha the Movie 2nd A's	Aniplex
Tokyo Magnitude 8.0 (TV)	Asmik Ace Entertainment, Inc.
Eureka Seven (TV)	Bandai Entertainment
School Rumble (TV)	Marvelous Entertainment
Parasyte -the maxim- (TV)	Forecast Communications
Kizumonogatari Part 2: Nekketsu (movie)	Aniplex
planetarian: Hoshi no Hito (movie)	Asmik Ace, Inc.
Hinamatsuri (TV)	unknown
Ghost in the Shell (movie)	Bandai Visual
Now and Then, Here and There (TV)	AIC
Puella Magi Madoka Magica the Movie Part 2: Eternal	Aniplex
Kill la Kill (TV)	Aniplex
Berserk: The Golden Age Arc II - The Battle for Doldrey (movie)	BERSERK FILM PARTNERS
Wagnaria!!3 (TV)	Aniplex
Kizumonogatari Part 1: Tekketsu (movie)	Aniplex
Puella Magi Madoka Magica the Movie Part 1: Beginnings	Aniplex
Puella Magi Madoka Magica The Movie Part 3: Rebellion	Aniplex
Kimagure Orange Road: The Movie	Pierrot
Lovely Complex (TV)	Shueisha
Porco Rosso (movie)	Japan Airline
Hikaru No Go: New Year Special	Dentsu Inc.
Mobile Suit Gundam - The Movie Trilogy	Sunrise
Hajime no Ippo - Mashiba vs. Kimura (OAV)	unknown
(The) Place Promised in Our Early Days (movie)	CoMix Wave Films
Cardcaptor Sakura Movie 2: The Sealed Card	Bandai Visual
Legend of the Galactic Heroes: A Hundred Billion Stars, A Hundred Billion Lights (OAV)	Hiroaki Antachi
(The) Wind Rises (movie)	Buena Vista Home Entertainment
Detroit Metal City (OAV)	Beyond C.
(The) Slayers Next (TV)	J.C. Staff
KenIchi the Mightiest Disciple (TV)	TMS Entertainment
Strawberry Panic! (TV)	Dwango
ReLIFE (OAV)	unknown
Princess Jellyfish (TV)	Atsushi Terada
Bamboo Blade (TV)	AIC
Initial D: Fourth Stage (TV)	OB Planning
One Piece Film Strong World (movie 10)	Bandai Co., Ltd.
Mobile Suit Gundam 00 (TV)	Mainichi Broadcasting System
Food Wars! The Second Plate (TV)	unknown
Bakuman. (TV)	NHK Enterprises
Silver Spoon (TV)	Kouichirou Natsume
Hikaru no Go (TV)	Dentsu Inc.
Owarimonogatari (TV)	unknown
Hajime no Ippo Rising (TV)	unknown
Banner of the Stars II (TV)	Bandai Visual
ReLIFE (TV)	Aniplex
Treasure Island (TV)	TMS Entertainment
Gunbuster (OAV)	Tadatsugu Hayakawa
Higurashi no Naku Koroni Kai (TV)	Frontier Works
Case Closed: The Phantom of Baker Street (movie)	Detective Conan Production Committee
Samurai 7 (TV)	G.D.H.
Voices of a Distant Star (OAV)	CoMix Wave Films
A Lull in the Sea (TV)	Animax
Slam Dunk (TV)	Toei Animation
Doraemon the Movie: Nobita and the Steel Troops: The New Age	Asatsu-DK
Full Moon o Sagashite (TV)	NAS
Mobile Suit Zeta Gundam (TV)	Nagoya Broadcasting Network
Psycho-Pass (TV)	Dentsu Inc.
Sayonara, Zetsubou-Sensei (TV)	Starchild Records
FLCL (OAV)	FLCL Production Committee
(The) Story of Saiunkoku Second Series (TV 2)	NHK
(The) Ancient Magus' Bride (TV)	Flying Dog
Case Closed: Captured in Her Eyes (movie)	Kyokuichi Tokyo Movie Shinsha
Case Closed: The Last Magician of the Century (movie)	Detective Conan Production Committee
(The) Secret World of Arrietty (movie)	Dentsu Inc.
Genshiken (TV)	GENCO
Miss Kobayashi's Dragon Maid (TV)	ABC Animation
Touch (TV)	Asatsu-DK
Kyo kara Maoh! 3rd Series (TV)	NHK
Black Lagoon: Roberta's Blood Trail (OAV)	Black Lagoon Production Team
Genshiken 2 (TV)	GENCO
Log Horizon (TV)	NHK
Big Windup! Season 2 (TV)	A-1 Pictures
Case Closed: Countdown to Heaven (movie)	Kyokuichi Tokyo Movie Shinsha
Kaleido Star: Legend of Phoenix - Layla Hamilton Story (OAV)	GONZO
Saint Seiya: The Hades Chapter - Sanctuary (OAV)	unknown
Junjō Romantica (TV)	Frontier Works
Aria - The Natural (TV)	ARIA Company
Claymore (TV)	avex mode
Zoku Sayonara Zetsubō Sensei (TV)	Starchild Records
Non Non Biyori Repeat (TV)	Janice Williams
Giant Robo (OAV)	Amuse Video
Legend of the Galactic Heroes: Spiral Labyrinth (OAV)	Kitty Films
Nisemonogatari (TV)	Aniplex
Ace of Diamond: Second Season (TV)	unknown
Fruits Basket (TV)	Furuba Production Committee
From Up On Poppy Hill (movie)	Buena Vista Home Entertainment / Disney
Perfect Blue (movie)	Rex Entertainment
When They Cry - Higurashi (TV)	"When Cicadas Cry" Production Committee
Kimagure Orange Road (TV)	Pierrot
Birdy the Mighty Decode:02 (TV)	Kouichirou Natsume
Soul Eater (TV)	BONES
Penguindrum (TV)	Mainichi Broadcasting System
Baby Blue (movie)	Studio 4°C
Hanada Shōnen-shi (TV)	Nippon Television Network
Full Metal Panic! (TV)	Fuji Television Network
Haré+Guu Deluxe (OAV)	Bandai Visual
xxxHOLiC: Rō (OAV)	unknown
Emma: A Victorian Romance (TV)	Enterbrain
Macross Zero (OAV)	Bandai Visual
(The) Garden of Sinners/recalled out summer (movie)	Aniplex
Space Battleship Yamato 2199 (movie)	AIC
Mobile Suit Gundam: The Origin (OAV)	Sunrise
(The) Tatami Galaxy (TV)	Emiko Uchimura
Chihayafuru 2 (TV)	Nippon Television Network
One Piece "3D2Y" Ace no Shi wo Koete! Luffy Nakama to no Chikai (special)	Fuji Television Network
Tamayura: Sotsugyō Shashin (movie series)	Animatic
(The) Vision of Escaflowne (TV)	Sunrise
Mobile Suit Gundam: Iron-Blooded Orphans (TV 2)	Mainichi Broadcasting System
Magical Girl Lyrical Nanoha A's (TV)	Nanoha A's Project
Fairy Tail Zero (TV)	unknown
(The) Eccentric Family (TV)	Bandai Visual
Read or Die (OAV)	Aniplex
Fate/stay night: Heaven's Feel I. presage flower (movie)	Aniplex
Durarara!! (TV)	Aniplex
Broken Blade (movie series)	Bandai Visual
Yu Yu Hakusho: Ghost Files (TV)	Fuji Television Network
Fate/stay night: Unlimited Blade Works (TV 2)	ufotable
Ga-Rei-Zero (TV)	AIC
Macross Plus Movie Edition	Bandai Visual
(The) Disastrous Life of Saiki K. (TV 2)	unknown
Kaiji (TV)	D.N. Dream Partners
Gintama Season 4 (TV 6/2017)	unknown
Black Butler: Book of Murder (OAV)	Aniplex
Tsubasa: Spring Thunder (OAV)	Kodansha
(The) Story of Saiunkoku (TV)	NHK
Crest of the Stars (TV)	Bandai Visual
Urusei Yatsura: Beautiful Dreamer (movie)	Kitty Films
Gintama (OAV)	unknown
On Your Mark (movie)	Real Cast Inc.
Hanamonogatari (TV)	Aniplex
Toward the Terra (TV)	Aniplex
Genshiken (OAV)	unknown
Mobile Suit Gundam Seed (TV)	Asatsu-DK
KONOSUBA - God's blessing on this wonderful world! 2 (TV)	unknown
Mind Game (movie)	Asmik Ace Entertainment, Inc.
Goku Sayonara Zetsubō Sensei (OAV)	unknown
Daicon films (special)	DAICON 3 Jikkou Iinkai
Saga of Tanya the Evil (TV)	unknown
Baby Steps (TV 2)	unknown
Redline (movie)	Kiyotaka Ninomiya
City Hunter 2 (TV)	Shueisha
Big Windup! (TV)	Jun Katou
Initial D: Second Stage (TV)	Fuji Television Network
Jormungand Perfect Order (TV)	Geneon Universal Entertainment
K-ON! (movie)	K-On! Movie Committee
InuYasha: The Final Act (TV)	Shogakukan-Shueisha Productions
One Piece Film Z (movie)	Chihiro Kameyama
(The) Dog of Flanders (movie)	Fuji Pacific Music Publisher
Mahō Sensei Negima!: Mō Hitotsu no Sekai (OAV)	unknown
Gintama: The Movie	Aniplex
Hozuki's Coolheadedness (TV 2)	unknown
Lunar Legend Tsukihime (TV)	Geneon Entertainment, Inc.
Zan Sayonara Zetsubō Sensei (TV)	unknown
Rurouni Kenshin: Reflection (OAV)	SME Visual Works
Steins;Gate: The Movie - Load Region of Déjà Vu	Gaku Iwasa
Hanasaku Iroha: Home Sweet Home (movie)	Bandai Visual
Kurenai (TV)	Kurenai Production Committee
Death Parade (TV)	Madhouse
Kyousougiga (TV)	unknown
Barakamon (TV)	Atsushi Fukushi
Aggretsuko (ONA)	FANWORKS, Inc.
(The) Irresponsible Captain Tylor (TV)	Akira Takamura
Patema Inverted (movie)	Asmik Ace Entertainment, Inc.
Revolutionary Girl Utena (TV)	unknown
Banner of the Stars (TV)	Bandai Visual
Hidamari Sketch × Honeycomb (TV)	Aniplex
Barefoot Gen (movie)	GEN Productions
Wagnaria!!2 (TV)	Aniplex
Children Who Chase Lost Voices (movie)	CMMMY
Case Closed: The Fourteenth Target (movie)	Detective Conan Production Committee
My-HiME (TV)	Sunrise
Ghost in the Shell S.A.C. Solid State Society 3D (movie)	unknown
Yona of the Dawn (TV)	Age Global Networks
Natsume Yūjin-Chō: Itsuka Yuki no Hi ni (OAV)	unknown
Detective Conan: The Lost Ship in The Sky (movie 14)	Nippon Television Network
Sound! Euphonium (TV)	Kyoto Animation
Mirai (movie)	Chukyo TV
One Piece (TV)	Asatsu-DK
Shigofumi - Letters from the Departed (TV)	Bandai Visual
Trigun: Badlands Rumble (movie)	Flying Dog
Lucky Star (TV)	Kadokawa Entertainment
Hidamari Sketch × Hoshimittsu (TV)	Tokyo Broadcasting System
INTERSTELLA 5555: The 5tory of the 5ecret 5tar 5ystem (movie)	Toei Animation
Silver Spoon (TV 2)	Aniplex
RahXephon (TV)	Asatsu-DK
Gurren Lagann the Movie –Childhood's End-	Aniplex
My Teen Romantic Comedy SNAFU TOO! (TV)	Janice Williams
Tsukimonogatari (TV)	Aniplex
His and Her Circumstances (TV)	GAINAX
Tsukigakirei (TV)	unknown
Girls' Last Tour (TV)	unknown
Kobato. (TV)	D.N. Dream Partners
Vampire Hunter D: Bloodlust (movie)	Animate
Berserk: The Golden Age Arc I - The Egg of the King (movie)	BERSERK FILM PARTNERS
Doukyusei -Classmates- (movie)	unknown
House of Five Leaves (TV)	Dentsu Inc.
School Rumble: Extra Class (OAV)	Akihiro Yuasa
Laid-Back Camp (TV)	Hikaru Sakamoto
Nekomonogatari (Black) (TV)	Aniplex
My Love Story!! (TV)	Nippon Television Network
Glass Mask (TV 2/2005)	TMS Entertainment
Heartcatch Precure! Hana no Miyako de Fashion Show…Desu ka!? (movie)	Asatsu-DK
Food Wars! The Third Plate (TV)	unknown
Ergo Proxy (TV)	Geneon Entertainment Inc.
Tenchi Muyo! Ryo-Ohki (OAV 2/1994)	Pioneer LDC
Ghost in the Shell: Arise (OAV)	Hideji Kaneko
Love, Chunibyo & Other Delusions! (TV)	Chu-2byo Production Partners
Strawberry Marshmallow (OAV)	MediaWorks
Initial D: Third Stage (movie)	Tatsumi Yoda
Master Keaton (TV)	Shogakukan-Shueisha Productions
Banner of the Stars III (OAV)	Bandai Visual
Final Fantasy VII: Advent Children (movie)	Square Enix
Macross Plus (OAV)	Bandai Visual
Fullmetal Alchemist: The Movie - Conqueror of Shamballa	Anime Film
Night is Short, Walk On Girl (movie)	unknown
Hayate the Combat Butler!! (TV)	Shogakukan-Shueisha Productions
Daily Lives of High School Boys (TV)	Happinet Pictures
Attack on Titan: No Regrets (OAV)	unknown
(The) Disastrous Life of Saiki K. (TV)	unknown
Initial D: Final Stage (TV)	unknown
Hidamari Sketch: Sae/Hiro Sotsugyō-hen (OAV)	Aniplex
Tekkonkinkreet (movie)	Aniplex
Hyōka (TV)	chara-ani.com
Tari Tari (TV)	Bandai Visual
Little Witch Academia (movie)	unknown
Moshidora (TV)	NHK
(The) Ancient Magus' Bride: Those Awaiting a Star (OAV)	Production I.G
Shakugan no Shana (TV)	Shakugan no Shana Production Committee
Attack on Titan (TV 3/2018)	unknown
Food Wars! The Third Plate (TV 2)	unknown
A Letter to Momo (movie)	Bandai Visual
Rage of Bahamut: Genesis (TV)	Cygames
(The) Cat Returns (movie)	Studio Ghibli
xxxHOLiC: Shunmuki (OAV)	unknown
xxxHOLiC: Rō Adayume (OAV)	unknown
Kino's Travels: Life Goes On (movie)	Susumu Kudo
Detective Conan: The Private Eyes' Requiem (movie 10)	Hideyuki Takai
GATE (TV 2)	GENCO
Mobile Suit Gundam: The 08th MS Team (OAV)	Bandai Visual
Zan Sayonara Zetsubō Sensei Bangai-chi (OAV)	unknown
Kamichu! (TV)	Aniplex
Hidamari Sketch × Hoshimittsu (special)	Hidamari Apartments Administration
Noein - to your other self (TV)	Bandai Channel
Hōzuki no Reitetsu (OAV)	unknown
Seto no Hanayome (OAV)	unknown
Shonen Onmyouji (TV)	unknown
Scrapped Princess (TV)	BONES
Full Metal Panic! The Second Raid (OAV)	Full Metal Panic! Film Partners
Tenchi Muyo! War on Geminar (OAV)	AIC
White Album 2 (TV)	AQUAPLUS
Tiger & Bunny The Movie -The Rising-	Asatsu-DK
Ushio & Tora (TV 2)	Janice Williams
JoJo's Bizarre Adventure: Stardust Crusaders Egypt Arc (TV)	JoJo's Bizarre Adventure Production Committee
Hidamari Sketch × 365 (TV)	Aniplex
Gunslinger Girl (TV)	Bandai Visual
Little Witch Academia (TV)	Good Smile Company
Giovanni's Island (movie)	Japan Association of Music Enterprises
Colorful (movie)	Atsushi Terada
Steins;Gate 0 (TV)	Future Gadget Lab
Megalobox (TV)	Bandai Namco Arts
Akira (movie)	Akira Committee Company Ltd
Another (TV)	Hiroyasu Asami
Detective Conan: The Raven Chaser (movie 13)	Nippon Television Network
From the New World (TV)	A-1 Pictures
Blood+ (TV)	Aniplex
Lupin the Third: Jigen's Gravestone (movie)	TMS Entertainment
Waiting in the Summer (TV)	AT-X
Strawberry Marshmallow (TV)	Ichigo Mashimaro Partners
Queen Millennia (TV)	Toei Animation
Inuyashiki Last Hero (TV)	Aniplex
Case Closed The Movie: The Time Bombed Skyscraper	Detective Conan Production Committee
Fairy Tail (TV 2/2014)	A-1 Pictures
(The) Seven Deadly Sins: Revival of The Commandments (TV)	A-1 Pictures
Fullmetal Alchemist: Brotherhood (OAV)	unknown
Full Metal Panic! Invisible Victory (TV)	unknown
